rvu: omu xck gfy
blz: out
wyc: out
pnw: fdy
zqo: pnw ftr psf lfo mfk
gne: out
ipf: yfs epr blz fxw
fai: zql wyc usn
zjo: yic psf vhb ndf
psf: fbq gne
fbq: out
gdx: abw psf gyl
cwp: out
qgm: rvu
fft: ydd uqg gyl out
yic: blz gne wyc wob cwp
svr: ndf gkr rng xvc dac
hit: out
sej: epr rng lyw
wje: xwh
otb: ncb wje
epr: yfs xwh vhb out
xvc: qah cki bjz coh
znz: wir
gkr: kpn zjo wob usn
yfs: out
xwh: wob yfs
ayw: ftr sie was fbq tou
gyl: out
hzp: yic fbq qcl psf
uqg: wyc wob hit cwp coh
ftr: ndf qah sie
wir: out
vhr: vau
qjj: xck fxw
lfo: zjo ydd ncb hit fft
cqu: qah wyc was out
abw: yic ndf znz usn bjz
gfy: cwp psf gch
afn: xwh out
tou: fbq zra wob out
wob: out
zra: gne
xck: xwh uqg wir wob
vhb: fdy wir xwh psf bjz out
psb: kpn kfz
lha: lyw ydd nai gfy
ofp: fai fxw blz pnw
was: out
kxl: llm zjo zvz
zvz: qcl was mfk fdy
gyw: abw fhc sfi uqg
kyz: qcl gne cwp usn vsp
ose: fbq hit
fgy: llm yfs mfk fbq
sfi: cwp
kbj: cwp kpn znz vqw
nai: pnw tou hit blz ydd out
qah: blz gyl wyc fbq hit out
dac: zra psf mfk fft
fdy: yfs wyc blz
gpq: xvc lkh vau ose
vqw: zjo omu sfi pnw
cki: psf fdy out
mbt: sie
mfk: wob gch
ggo: xck gpq rvu lfo out
sie: wob uqg gch blz gne
qpd: lkh blz uqg kxl
llm: gyl gne uqg
srz: cwp zra dac
tdm: gpq
omu: hit wir
tol: psf vhb bjz fdy cwp
bgr: psf wir fai epr
kfz: coh hzp fbq
fxw: lyw fft vau
bjz: cwp gne wyc gyl
kpn: xck gpx ndf cki
rng: coh out
vsp: xvc yfs gfy gch hzp
lyw: vhb fbq out
vau: yic zra out
you: rvu zbf lyw out
gul: yfs cki hit zql
ncb: was llm out
ywe: wyc gfy
qpe: xvc lfo out
gpx: fbq uqg psf was
coh: out
gch: was gne blz coh cwp
uec: ogw
eyc: mfk kfz zvz lha fhc
ndf: cwp was wyc yfs gyl
ogw: blz gpx tol
ydd: wir hit
afq: bjz wir
fhc: ydd
usn: ydd gch gne gyl psf
zql: mfk rvu fft blz
wge: znz gch zra tol
lkh: qah yic ydd coh usn
qcl: yic wyc bjz yfs gch
zbf: uqg eyc fxw